#################################################################################
#S  #   #     #         #               #   #               #           #   #   #
### # # # ### ##### ### # ############# # # # ##### ### ### # ##### # ### # # # #
# #   #   # # #     # # #       #   #   # #   #   # #   #   #   # # # #   #   # #
# ######### # # ##### # ### ### ### # ######### # # # ######### # # ### ####### #
#   #       #   #     #   #   # #   #     #   # # # # #         # #   # #     # #
# # # # ######### # # ### ##### # ####### # # # # ### # ######### ### # # ### # #
# #   # #         # # # #     # # #     #   # # # #   #   #   #     #     #   # #
####### # ####### # # # ##### # # # # ####### # # # ##### # # ##### ########### #
#     # # # #   # # #     #   # #   #   #   #   # # #       #   #   # #         #
# ### # # # # # ### ##### # ### ####### # # ##### # # ######### # # # # ####### #
# # # # #   # #   #   #   #   # #     #   #       #       #   #   #   # #   #   #
# # # # ### # ### ### ### ### # # ### # ################### # ######### # # # ###
# #     #   # #     #   # # # # # #   # #     #       #     # #   #     # # #   #
# ####### ### ##### ### # # # # # # ### # # ### # ### # ##### # # # ####### ### #
#         # #     #     #   # #   # #   # # #   # # # #     #   #   # #     #   #
# ######### ##### ########### ##### # ### ### ### # # # ### ######### # # ### ###
#     #   #   #   #         # #     # #     # #   # # #   #   #       # # #   # #
##### # # ### # # # ####### # # ##### ##### # # ### # ### ### ### ### # # # ### #
#   #   #     # # # #     #   #   #   #   #   # # #   #   # #   # # #   # # #   #
# # ####### ### # # # ### ##### # # ### # ##### # # ### ### ### # # ##### # # ###
# #   #     #   # # #   # #     # #     #       # # #   #     # #   #   # # #   #
# ##### ##### # ### ### # # ##### ### ########### # ### ### # # ### # ### # ### #
# #   #   #   # #   #   #   #   #   # #     #         #   # # #   #   #   #     #
# # # # ### ### # ##### ##### # ### ### ### ######### ### # # ### ##### ####### #
#   #   #   #   #     #     # #   # #   # #       #   #     #   # #   #     #   #
# ####### ### ####### ##### # ### # # ### ####### # ########### # # # ##### # ###
# #       #         #     # # #     #           # # #       #   #   #     #     #
# # ##################### ### ##### ##### ####### # ### ### ####### ##### ##### #
# #     #   #     #     #   #   #   #   # #       #     # # #     #     #     # #
##### # # # # ### # ### ### # # ##### # # # ### ######### # # ### ##### ##### ###
#   # # # #   # # #   #   # # #       #   #   # #     #     # #     #       #   #
# # # # # ##### # ### ### # ### ############# ### ### # ##### ##### # ##### ### #
# # # # # #     #     #   #   #     #       #     #   #   #     #   # #   #   # #
# # ### # ##### ####### ##### ##### # ##### # ##### ##### ##### # ##### # ##### #
# #     # #   #     # # #     #   # # #     #   #   #   #       # #     #       #
# ####### # # ### # # # # ##### # # # # ####### # ### # ######### ### ######### #
# #     #   #     #   #   #     #   # # #     # # #   #   #     #     #     #   #
# # ### ############# ############### # # ### ### # ####### # ######### ##### ###
#     #                               #   #       #         #                  E#
#################################################################################
